21
11
WWWWWWWWWWWWWWWWWWWWW
WGGGWWWWWWWWWWWWWWWWW
WGGGVGGGGGDGRGGGGGGGW
WGRGGGGGGGGGDGGGGGGGW
WGGGGDGGGGGGGGDGGGGGW
WGGVVGGGGGGGGGRGGGGEW
WGRVBGGDGGGGGRRGGGGVW
WGGRRGGGGGGGGGRRGGGGW
WWWWWWWVVGWWWWWWWWWWW
WGGGRGGDGVGGRGRGGVVGW
WWWWWWWWWWWWWWWWWWWWW
